1111111111111111
1P000C0000000C01
1E00000010000001
1C1110000C001111
1000010000000C01
100000001000X001
11110C00C0000011
1111111111111111