11111111
100100P0
1E0000011
1C000001
11111111