111111111111
1P0000000001
101111111101
1C1111111101
101011111101
100010000101
111010111101
1C0010000001
101111011111
1000000000E1
111111111111