111111111011
100000E00001
100000000001
100010001101
100C00000001
1111000P0001
111111111111